0011111111100
0121212121210
1111111111111
2121212121212
1111111111111
2121212121212
1111111111111
2121212121212
1111111111111
0121212121210
0011111111100